....................................#########
....................................#.......#
....................................#.......#
....................................#.......#
........................#######.....#.......#
........................#.....#.....#.......#
........................#.....#.#############
........................#.....#.#...#........
........................#.....#.#...#######..
........................#.....#.#.........#..
........................#.....#.#.........#..
........................#.....#.#.........#..
........................#########.........#..
..............................#...........#..
..............................#...........#..
..............................#...........#..
..............................######^.....#..
..........................................#..
..........................................#..
..........................................#..
..................................#########..
..................................#..........
............#########.............#..........
............#.......#.............#..........
..........#############.........#######......
..........#.#.......#.#.........#.#...#......
....#####.#.#.......#.#.........#.#...#......
....#...#.#.#.......#.#.........#.#...#......
#############.......#.#...#####.#.#####......
#...#...#.#.........#.#...#...#.#............
#...#######.........#############............
#.......#.............#...#...#..............
#.......#.............#########..............
#.......#.................#..................
#########.................#######............
................................#............
................................#............
................................#............
..............................#########......
................................#.....#......
................................#.....#......
................................#.....#......
................................#.....#......
................................#.....#......
................................#.....#......
................................#.....#......
................................#######......